%%%%%%%%%%%%%%
%P          G%
%%%%%%%%%%%%%%
% %%%%%%%%%%%%
%%%%%%%%%%%%%%