%%%%%%%%%%%%%%
%P           %
%            %
%            %
%            %
%            %
%            %
%           G%
%%%%%%%%%%%%%%
% % %%%%%%%%%%
%%%%%%%%%%%%%%
