%%%%%%%%%%%%%%%%%%%%%%%%%%%%%%%%%
%                               %
% %%%%%%%%%%%%%%%%%%%%%%%%%%%%% %
% %                           % %
% % %%%%%%%%%%%%%%%%%%%%%%%%% % %
% % %                       % % %
% % % %%%%%%%%%%%%%%%%%%%%% % % %
% % % %                   % % % %
% % % % %%%%%%%%%%%%%%%%% % % % %
% % % % %               % % % % %
% % % % % %%%%%%%%%%%%% % % % % %
% % % % % %GGGG       % % % % % %
% % % % % %%%%%%%%%%% % % % % % %
% % % % %             % % % % % %
% % % % %%%%%%%%%%%%%%% % % % % %
% % % %                 % % % % %
% % % %%%%%%%%%%%%%%%%%%% % % % %
% % %                     % % % %
% % %%%%%%%%%%%%%%%%%%%%%%% % % %
% %                         % % %
% %%%%%%%%%%%%%%%%%%%%%%%%%%% % %
%                             % %
%%%%%%%%%%%%%%%%%%%%%%%%%%%%%%% %
%%%         P                   %
%%%%%%%%%%%%%%%%%%%%%%%%%%%%%%%%%
% % % % %%%%%%%%%%%%%%%%%%%%%%%%%
%%%%%%%%%%%%%%%%%%%%%%%%%%%%%%%%%